1111111111111111111111111111111111111111111111111111111111111111111111111111111111111111111111111111111111111111111111111111111111111111
1P00000000000000000000000000000001100000000000000000000000000000000110000000000000000000000000000000011000000000000000000000000000000001
10000000000000000000000000C00000010000000000000000000000000C00000010000000000000000000000000C00000010000000000000000000000000C0000000001
10000000000000000000000000C00000010000000000000000000000000C00000010000000000000000000000000C00000010000000000000000000000000C0000000001
10000000000000000000000000C00000010000000000000000000000000C00000010000000000000000000000000C00000010000000000000000000000000C0000000001
10000000000000000000000000C00000010000000000000000000000000C00000010000000000000000000000000C00000010000000000000000000000000C0000000001
10000000000000000000000000C00000010000000000000000000000000C00000010000000000000000000000000C00000010000000000000000000000000C0000000001
10000000000000000000000000C00000010000000000000000000000000C00000010000000000000000000000000C00000010000000000000000000000000C0000000001
10000000000000000000000000C00000010000000000000000000000000C00000010000000000000000000000000C00000010000000000000000000000000C0000000001
10000000000000000000000000C00000010000000000000000000000000C00000010000000000000000000000000C00000010000000000000000000000000C0000000001
10000000000000000000000000C00000010000000000000000000000000C00000010000000000000000000000000C00000010000000000000000000000000C0000000001
1000000000000000000000000000000001000000000000000000000000000000001000000000000000000000000000000001000000000000000000000000000000000001
1000000000000000000C00000000000001000000000000000000C00000000000001000000000000000000C00000000000001000000000000000000C00000000000000001
1000000000000000000000000000000000000000000000000000000000000000000000000000000000000000000000000000000000000000000000000000000000000001
1000000000000000000000000000000000000000000000000000000000000000000000000000000000000000000000000000000000000000000000000000000000000001
10000000000000000000000000000C0000000000000000000000000000000000000000000000000000000000000000000000000000000000000000000000000000000001
1000000000000000000000000000000000000000000000000000000000000000001000000000000000000000000000000001000000000000000000000000000000000001
1000000C00000000000000000000000E00000000000000000000000000000000000000000000000000000000000000000000000000000000000000000000000000000001
1000000000000000000000000000000000000000000000000000000000000000000000000000000000000000000000000000000000000000000000000000000000000001
1111111111111111111111111111111111111111111111111111111111111111111111111111111111111111111111111111111111111111111111111111111111111111